Adi Widya Pasraman Guna Dharma 	Banggai	SD
SD INP. 01 BUNTA	Banggai	SD
SD INP. 01 SUMBER MULYA	Banggai	SD
SD INP. 03 SUMBER MULYA	Banggai	SD
SD INP. MATABAS	Banggai	SD
SD INP. SIUNA	Banggai	SD
SD INP.3 BUNTA	Banggai	SD
SD INP.4 BUNTA	Banggai	SD
SD INPRES 02 BERINGIN JAYA	Banggai	SD
SD INPRES 8 BERTINGKAT LUWUK	Banggai	SD
SD INPRES BINSIL 2	Banggai	SD
SD INPRES NIPA	Banggai	SD
SD KATOLIK SANTO YOSEPH SULUBOMBONG	Banggai	SD
SD KRISTEN AXEL MOZES	Banggai	SD
SDN 1 INPRES BAYA	Banggai	SD
SDN 1 INPRES LAUWON	Banggai	SD
SDN 3 INPRES KINTOM	Banggai	SD
SDN 4 INP. LUWUK	Banggai	SD
SDN BINSIL 1	Banggai	SD
SDN BORAS	Banggai	SD
SDN DUWATA KARYA	Banggai	SD
SDN INP. BASABUNGAN	Banggai	SD
SDN INP. PAKOWA	Banggai	SD
SDN INP. PISOU	Banggai	SD
SDN INP. SEPA	Banggai	SD
SDN INPRES HTI	Banggai	SD
SDN INPRES TETESULU	Banggai	SD
SDN LAMBULI	Banggai	SD
SDN PONGIAN 1	Banggai	SD
SDN TRANS BINSIL 3	Banggai	SD
SLB NEGERI TOILI	Banggai	SMPLB
SMA ISLAM TERPADU ASSOHWAH TOILI	Banggai	SMA
SMA KRISTEN GKLB LUWUK	Banggai	SMA
SMK HAYATUL ISLAM	Banggai	SMK
SMK PERTANIAN MUH. BUALEMO	Banggai	SMK
SMP ISLAM TERPADU AR RAYYAN WAHDAH	Banggai	SMP
SMP ISLAM TERPADU AS-SOHWAH TOILI	Banggai	SMP
SMP IT UMMUL QURAN	Banggai	SMP
SMP KATOLIK SULUBOMBONG	Banggai	SMP
SMP NEGERI SATU ATAP BATUI	Banggai	SMP
SMP RK SANTO YOSEP LUWUK	Banggai	SMP
SD ISLAM TERPADU	Banggai Kepulauan	SD
SD KATOLIK 1 SANTO DON BOSCO NULION	Banggai Kepulauan	SD
SDN 1 INPRES SALAKAN	Banggai Kepulauan	SD
SDN 2 INPRES BULAGI	Banggai Kepulauan	SD
SDN 2 INPRES PAISUBATU	Banggai Kepulauan	SD
SDN 2 INPRES PATUKUKI	Banggai Kepulauan	SD
SDN ALAKASING	Banggai Kepulauan	SD
SDN INPRES SAMBULANGAN	Banggai Kepulauan	SD
SMP INTEGRAL HIDAYATULLAH BANGGAI KEPULAUAN	Banggai Kepulauan	SMP
SMP ISLAM TERPADU	Banggai Kepulauan	SMP
SMP MARIS STELLA SAMBIUT	Banggai Kepulauan	SMP
PKBM CAHAYA ILMU	Banggai Laut	PAKET C
SDN 2 INPRES PAKASUA	Banggai Laut	SD
SDN 4 INPRES BANGGAI	Banggai Laut	SD
SDN INPRES PAISUBEBE	Banggai Laut	SD
SDN POSOSLALONGO	Banggai Laut	SD
SEKOLAH DASAR  BAULALONGO	Banggai Laut	SD
SMK DHU'AFA BANGGAI	Banggai Laut	SMK
PKBM MENGGAPAI ASA	Buol	PAKET C
SMK NEGERI PERIKANAN DAN KELAUTAN GADUNG	Buol	SMK
SMP ISLAM AL-HIJRAH	Buol	SMP
SMP ISLAM FARID AS-SHOLEH NW NEGERILAMA	Buol	SMP
MADYAMA WIDYA PASRAMAN DWI JENDRA	Donggala	SMP
PKBM JENDELA ILMU	Donggala	PAKET C
SD ALKHAIRAAT BOU	Donggala	SD
SD ALKHAIRAAT LABUAN KUNGGUMA	Donggala	SD
SD BK BAMBAKANINI	Donggala	SD
SD BK GIMPUBIA	Donggala	SD
SD BK PALINTUMA	Donggala	SD
SD BK TAMODO	Donggala	SD
SD BK WATAMBUNE	Donggala	SD
SD DDI LABUAN PANIMBA	Donggala	SD
SD ISLAM YPPI DONGGALA	Donggala	SD
SD IT IZZUL ISLAM	Donggala	SD
SD NURUL ISLAM NUPABOMBA	Donggala	SD
SDK SOLAFIDE SETIA BONENGGAYA	Donggala	SD
SDN 1 SOJOL UTARA	Donggala	SD
SDN 10 RIO PAKAVA	Donggala	SD
SDN 11 RIO PAKAVA	Donggala	SD
SDN 11 SOJOL	Donggala	SD
SDN 13 DAMPELAS	Donggala	SD
SDN 13 SOJOL	Donggala	SD
SDN 14 SOJOL	Donggala	SD
SDN 15 DAMPELAS	Donggala	SD
SDN 15 RIO PAKAVA	Donggala	SD
SDN 17 SOJOL	Donggala	SD
SDN 18 SOJOL	Donggala	SD
SDN 19 SOJOL	Donggala	SD
SDN 2 SOJOL	Donggala	SD
SDN 2 SOJOL UTARA	Donggala	SD
SDN 21 SOJOL	Donggala	SD
SDN 22 SOJOL	Donggala	SD
SDN 26 SOJOL	Donggala	SD
SDN 28 SOJOL	Donggala	SD
SDN 29 DAMPELAS	Donggala	SD
SDN 3 SOJOL	Donggala	SD
SDN 3 SOJOL UTARA	Donggala	SD
SDN 4 SOJOL UTARA	Donggala	SD
SDN 5 SOJOL	Donggala	SD
SDN 5 SOJOL UTARA	Donggala	SD
SDN 6 SOJOL	Donggala	SD
SDN 6 SOJOL UTARA	Donggala	SD
SDN 7 SOJOL UTARA	Donggala	SD
SDN 8 SOJOL	Donggala	SD
SDN 8 SOJOL UTARA	Donggala	SD
SMA NEGERI 2 SOJOL	Donggala	SMA
SMKN 1 SOJOL UTARA	Donggala	SMK
SMP  SATU ATAP NEGERI 3 TANANTOVEA	Donggala	SMP
SMP ALKHAIRAAT BOU	Donggala	SMP
SMP BK PAKAVA	Donggala	SMP
SMP NEGERI 1 SOJOL UTARA	Donggala	SMP
SMP NEGERI 9 SATAP SOJOL	Donggala	SMP
SMP NEGERI SATAP 3 SOJOL UTARA	Donggala	SMP
SMP NEGERI SATU ATAP 2 SOJOL UTARA	Donggala	SMP
SMP SATU ATAP NEGERI 3 SINDUE TOBATA	Donggala	SMP
SMPN 7 SATAP SOJOL	Donggala	SMP
PKBM GELATIK	Kota Palu	PAKET C
PKBM MANTIKULORE	Kota Palu	PAKET B
SD DDI CABANG PALU	Kota Palu	SD
SD IMANUEL PALU	Kota Palu	SD
SD INPRES 15 WARA PANTOLOAN	Kota Palu	SD
SD ISLAM AL AZHAR 63 PALU	Kota Palu	SD
SD Islam Khalifah Palu	Kota Palu	SD
SD ISLAM OTAK KANAN	Kota Palu	SD
SD ISLAM PERSIS	Kota Palu	SD
SD ISLAM TERPADU IBNUL MUBAROK PALU	Kota Palu	SD
SD Islam Terpadu Qurrota Ayun Baiya	Kota Palu	SD
SD IT Al Fahmi	Kota Palu	SD
SD KARUNA DIPA	Kota Palu	SD
SD KRISTEN ADVENT PALU	Kota Palu	SD
SD KT BAIYA	Kota Palu	SD
SD KT MAMBORO	Kota Palu	SD
SD NURUL ISLAM	Kota Palu	SD
SD PGRI	Kota Palu	SD
SDI ALHIDAYAH BESUSU	Kota Palu	SD
SDI IQRA BINA POTENSI PETOBO	Kota Palu	SD
SDI NURUL IKHLAS PALUPI	Kota Palu	SD
SDN INPRES PERUMNAS BALAROA	Kota Palu	SD
SDN WANA	Kota Palu	SD
SLB ADINDA HUMAIRA	Kota Palu	SDLB
SLB HUNTAP	Kota Palu	SDLB
SLBS ADJERNI SUNUSI	Kota Palu	SDLB
SMA GPID PALU	Kota Palu	SMA
SMA ISLAM OTAK KANAN	Kota Palu	SMA
SMA IT PLUS BINA ANAK BANGSA	Kota Palu	SMA
SMA KATOLIK SANTO ANDREAS PALU	Kota Palu	SMA
SMA Kristen Gamaliel Palu	Kota Palu	SMA
SMAS GKST IMANUEL PALU	Kota Palu	SMA
SMK ISLAMIC CENTER	Kota Palu	SMK
SMK MANDALASILA	Kota Palu	SMK
SMK NUSANTARA PALU	Kota Palu	SMK
SMK PELAYARAN TRI DHARMA PALU	Kota Palu	SMK
SMK PONPES ALKHAIRAAT PALU	Kota Palu	SMK
SMK PONPES AMALIA PALU	Kota Palu	SMK
SMP GPID PALU	Kota Palu	SMP
SMP IT AL FAHMI	Kota Palu	SMP
SMP NEGERI SATU ATAP LIK LAYANA	Kota Palu	SMP
SMP NEGERI TERBUKA 13 PALU (TUTUP)	Kota Palu	SMP
SMP NEGERI TERBUKA 16 PALU	Kota Palu	SMP
SMP NEGERI TERBUKA 3 PALU	Kota Palu	SMP
SMP RK ST PAULUS PALU	Kota Palu	SMP
SMP SWADAYA	Kota Palu	SMP
SMPS MIFTAAHUL KHAIRAAT PALU	Kota Palu	SMP
UTAMA WIDYA PASRAMAN WIRA DHARMA PALU	Kota Palu	SMA
PKBM  INTAN	Morowali	PAKET B
PKBM NUR	Morowali	PAKET B
SD ALKHAIRAAT ULUNAMBO	Morowali	SD
SD IMIP	Morowali	SD
SD NEGERI POO	Morowali	SD
SD NEGERI PULAU TENGAH	Morowali	SD
SD NEGERI PULAU TIGA	Morowali	SD
SD NEGERI TANONA	Morowali	SD
SD NEGERI TRANS 1 BULELENG	Morowali	SD
SDN 1 BAHOMAKMUR	Morowali	SD
SDN 1 LAFEU	Morowali	SD
SDN 1 ULUNAMBO	Morowali	SD
SDN 2 LAFEU	Morowali	SD
SDN 2 ULUNAMBO	Morowali	SD
SDN 3 ULUNAMBO	Morowali	SD
SDN BETE BETE	Morowali	SD
SDN BOELIMAU	Morowali	SD
SDN BUAJANGKA	Morowali	SD
SDN BULELENG	Morowali	SD
SDN FATUFIA	Morowali	SD
SDN GUSUMOTAHA	Morowali	SD
SDN JAWI JAWI	Morowali	SD
SDN KALEROANG	Morowali	SD
SDN KEUREA	Morowali	SD
SDN KOFALAGADI	Morowali	SD
SDN KURISA	Morowali	SD
SDN LABOTA	Morowali	SD
SDN LAKOMBULO	Morowali	SD
SDN LAMONTOLI	Morowali	SD
SDN LAROENAI	Morowali	SD
SDN LOMBOKITA	Morowali	SD
SDN MAKARTI JAYA	Morowali	SD
SDN MASADIAN	Morowali	SD
SDN MATANO	Morowali	SD
SDN MATARAPE	Morowali	SD
SDN MOROMPAITONGA	Morowali	SD
SDN NGAPAEA	Morowali	SD
SDN PADABAHO	Morowali	SD
SDN PADABALE	Morowali	SD
SDN PADALAA	Morowali	SD
SDN PADEI DARAT	Morowali	SD
SDN PADEI LAUT	Morowali	SD
SDN PADO PADO	Morowali	SD
SDN PAKU	Morowali	SD
SDN POLEWALI	Morowali	SD
SDN POWARU	Morowali	SD
SDN PULAU BAPA	Morowali	SD
SDN PULAU DUA DARAT	Morowali	SD
SDN PUUNGKEU	Morowali	SD
SDN SAMARENGGA	Morowali	SD
SDN SAMBALAGI	Morowali	SD
SDN TANDAOLEO	Morowali	SD
SDN TANGOFA	Morowali	SD
SDN TANJUNG HARAPAN	Morowali	SD
SDN TANJUNG TIRAM	Morowali	SD
SDN TEREBINO	Morowali	SD
SDN TORETE	Morowali	SD
SDN TORUKUNO	Morowali	SD
SDN TRANS BULELENG	Morowali	SD
SDN ULUNIPA	Morowali	SD
SDN WEREA	Morowali	SD
SMAN 1 BUNGKU PESISIR	Morowali	SMA
SMAN 1 BUNGKU SELATAN	Morowali	SMA
SMAN 1 MENUI	Morowali	SMA
SMK AL-KHAIRAAT BAHODOPI	Morowali	SMK
SMK NEGERI 1 MENUI	Morowali	SMK
SMKN 1 Bungku Selatan	Morowali	SMK
SMP BP NURUL UMMAH	Morowali	SMP
SMP NEGERI 1 BUNGKU PESISIR	Morowali	SMP
SMP NEGERI 1 BUNGKU SELATAN	Morowali	SMP
SMP NEGERI 1 MENUI	Morowali	SMP
SMP NEGERI 2 BUNGKU PESISIR SATU ATAP	Morowali	SMP
SMP NEGERI 2 BUNGKU SELATAN	Morowali	SMP
SMP NEGERI 2 MENUI	Morowali	SMP
SMP NEGERI 3 MENUI SATU ATAP	Morowali	SMP
SMP NEGERI 4 MENUI SATU ATAP	Morowali	SMP
SMP NEGERI 5 MENUI SATU ATAP	Morowali	SMP
SMP NEGERI 6 MENUI KEPULAUAN SATAP	Morowali	SMP
SMP NEGERI 7 MENUI SATU ATAP	Morowali	SMP
SMPN 3 BAHODOPI SATU ATAP	Morowali	SMP
SD Islam Terpadu AL-MUHAJIRIN	Morowali Utara	SD
SD NEGERI LANUMOR	Morowali Utara	SD
SD NEGERI MANDULA	Morowali Utara	SD
SD SMP SATU ATAP NEGERI LEMBO	Morowali Utara	SMP
SEKOLAH DASAR FATUMARANDO TERPADU	Morowali Utara	SD
PKBM ALMARANTALE	Parigi Moutong	PAKET B
PKBM LENTERA DESA	Parigi Moutong	PAKET B
PKBM SAHABAT ILMU	Parigi Moutong	PAKET B
PKBM SALUMPUNG JAYA	Parigi Moutong	PAKET B
SD INPRES 5 PALASA	Parigi Moutong	SD
SD KECIL DESPOT PETUNASUGI	Parigi Moutong	SD
SD KECIL KARYA MANDIRI	Parigi Moutong	SD
SD KECIL KOPI	Parigi Moutong	SD
SD KECIL OGOMEGANG	Parigi Moutong	SD
SD KECIL OGOTULO	Parigi Moutong	SD
SD KECIL PADAT KARYA	Parigi Moutong	SD
SD KECIL SAKINAH JAYA	Parigi Moutong	SD
SD KECIL SALUBANGA	Parigi Moutong	SD
SD KECIL TARIPA JAYA AVOLUA	Parigi Moutong	SD
SD KECIL TEPENCIL OGOLONGKAP	Parigi Moutong	SD
SD KECIL TERPENCIL  SIMOI	Parigi Moutong	SD
SD KECIL TERPENCIL BENDUNGAN BAINAA	Parigi Moutong	SD
SD KECIL TERPENCIL GUNUNG PANATALAN	Parigi Moutong	SD
SD KECIL TERPENCIL SINGGONITU	Parigi Moutong	SD
SD KECIL TORARANGA	Parigi Moutong	SD
SD KECIL TORIAPES	Parigi Moutong	SD
SD NEGERI AMALALANG	Parigi Moutong	SD
SD NEGERI INTI 1 SIDOAN	Parigi Moutong	SD
SD NEGERI INTI BAINAA	Parigi Moutong	SD
SD NEGERI INTI DUSUNAN	Parigi Moutong	SD
SD NEGERI INTI MALANGGO	Parigi Moutong	SD
SD NEGERI INTI PELAWA	Parigi Moutong	SD
SD NEGERI INTI SINIU	Parigi Moutong	SD
SD NEGERI SALMEKAR	Parigi Moutong	SD
SD NEGERI SAUSU PEORE	Parigi Moutong	SD
SD NEGERI TERPENCIL SIBALIDA	Parigi Moutong	SD
SD NEGERI UPT TERPENCIL MANINILI	Parigi Moutong	SD
SD TERPENCIL OGOLAU	Parigi Moutong	SD
SD TERPENCIL PATINGKE LOMBOK	Parigi Moutong	SD
SD TERPENCIL TAMBALANG TOMINI UTARA	Parigi Moutong	SD
SDK BABONG	Parigi Moutong	SD
SDK OLONGGATA	Parigi Moutong	SD
SDK PANGI	Parigi Moutong	SD
SDK PORAEGOA INDAH PARANGGI	Parigi Moutong	SD
SDK TERPENCIL GUNUNG PAKUKU	Parigi Moutong	SD
SDN KECIL TERPENCIL OGUANG	Parigi Moutong	SD
SMK HILAL KHAIRAAT BOLANO LAMBUNU	Parigi Moutong	SMK
SMP NEGERI SATU ATAP 1 KASIMBAR	Parigi Moutong	SMP
SMP NEGERI SATU ATAP 1 MOUTONG	Parigi Moutong	SMP
SMP NEGERI SATU ATAP 1 PARIGI TENGAH	Parigi Moutong	SMP
SMP NEGERI SATU ATAP 1 TAOPA	Parigi Moutong	SMP
SMP NEGERI SATU ATAP 2 PARIGI SELATAN	Parigi Moutong	SMP
SMP NEGERI TERBUKA 2 TOMINI	Parigi Moutong	SMP
SMP QURAN AL-IHSAN PARIGI	Parigi Moutong	SMP
SMP SATAP NEGERI 3 SAUSU	Parigi Moutong	SMP
SMP SATU ATAP NEGERI 3 ONGKA MALINO	Parigi Moutong	SMP
SD GKST BADANGKAIA	Poso	SD
SD GKST HANGGIRA	Poso	SD
SD GKST KELE'I	Poso	SD
SD GKST POLEGANYARA	Poso	SD
SD GKST TALABOSA	Poso	SD
SD GKST TARIPA	Poso	SD
SD GKST WUASA	Poso	SD
SD IT HIDAYATULLAH POSO	Poso	SD
SD KRISTEN GKST TAGOLU	Poso	SD
SDN BEAU	Poso	SD
SDN KATU	Poso	SD
SDN MEKAR SARI TAMADUE	Poso	SD
SDN PASAU	Poso	SD
SDN TOLAMBO	Poso	SD
SDN WINOWANGA	Poso	SD
SMA ALKHAIRAT TONGKO	Poso	SMA
SMK  ALKHAIRAT POSO	Poso	SMK
SMP NEGERI SATAP LENA	Poso	SMP
SMP NEGERI SATAP MAYOA	Poso	SMP
SMP NEGERI SATAP WATUMAETA	Poso	SMP
SMP NEGERI SATU ATAP DONGI-DONGI	Poso	SMP
SMP NEGERI SATU ATAP MASEWE	Poso	SMP
SMP NEGERI SATU ATAP TAMPEMADORO	Poso	SMP
SMP NEGERI SATU ATAP UELINCU	Poso	SMP
SMP NEGERI TERBUKA POSO PESISIR	Poso	SMP
SMP SATAP SEDOA	Poso	SMP
SMP SATU ATAP TINDOLI	Poso	SMP
SMPN SATAP BULILI	Poso	SMP
SD BK BANASU	Sigi	SD
SD BK BOLOBIA	Sigi	SD
SD BK BUNGA	Sigi	SD
SD BK DODA	Sigi	SD
SD BK DOMBU	Sigi	SD
SD BK GIMPU	Sigi	SD
SD BK JONO	Sigi	SD
SD BK KALAMANTA	Sigi	SD
SD BK KALAWARA	Sigi	SD
SD BK KAMARORA	Sigi	SD
SD BK KANTEWU	Sigi	SD
SD BK KOJA	Sigi	SD
SD BK LANGGA	Sigi	SD
SD BK LAWE	Sigi	SD
SD BK LEMPELERO	Sigi	SD
SD BK LEWARA	Sigi	SD
SD BK LONEBASA	Sigi	SD
SD BK MABERE	Sigi	SD
SD BK MAMU	Sigi	SD
SD BK MANE	Sigi	SD
SD BK MAPAHI	Sigi	SD
SD BK MARANATHA	Sigi	SD
SD BK MATANTIMALI	Sigi	SD
SD BK MORUI	Sigi	SD
SD BK NO 1 LINDU	Sigi	SD
SD BK OO	Sigi	SD
SD BK PANESI BAJA	Sigi	SD
SD BK PEANA	Sigi	SD
SD BK PELEMPEA	Sigi	SD
SD BK POLUROA	Sigi	SD
SD BK PORELEA	Sigi	SD
SD BK PUROO	Sigi	SD
SD BK RANTEWULU	Sigi	SD
SD BK TORO	Sigi	SD
SD BK TOWULU	Sigi	SD
SD BK TUWO	Sigi	SD
SD BK WATUBULA	Sigi	SD
SD BK WAYU	Sigi	SD
SD BK WIAPORE	Sigi	SD
SD BK WINATU	Sigi	SD
SD INP ONU	Sigi	SD
SD INP. MATAUE	Sigi	SD
SD INP. SALUA	Sigi	SD
SD INP. SUNGKU	Sigi	SD
SD INP. TORO	Sigi	SD
SD INP. TOWULU	Sigi	SD
SD ISLAM TERPADU AL QOLAM	Sigi	SD
SD ISLAM TERPADU QURROTA'AYUN	Sigi	SD
SDN  BOLADANGKO	Sigi	SD
SDN 4 TOMADO (SANGALI)	Sigi	SD
SDN BALAROA II	Sigi	SD
SDN BOBO	Sigi	SD
SDN BOBO	Sigi	SD
SDN INP KILO	Sigi	SD
SMA BK KALAWARA	Sigi	SMA
SMA IT QURROTA A'YUN SIGI	Sigi	SMA
SMK KRISTEN BALA KESELAMATAN MARANATHA	Sigi	SMK
SMP BK BALAMOA	Sigi	SMP
SMP BK KALAWARA	Sigi	SMP
SMP BK MARANATHA	Sigi	SMP
SMP BK PEANA	Sigi	SMP
SMP ISLAM PLUS (SMP IP) DARUL IFFAH	Sigi	SMP
SMP ISLAMIC PUE LASADINDI	Sigi	SMP
SMP NEGERI TERBUKA 1 MARAWOLA	Sigi	SMP
SMP NEGERI TERBUKA 2 DOLO	Sigi	SMP
SMP TERBUKA PALOLO	Sigi	SMP
PKBM Paddakauang	Tojo Una-Una	PAKET B
SD NEGERI  TANGKIAN	Tojo Una-Una	SD
SD-SMP NEGERI SATAP TUMBULAWA	Tojo Una-Una	SMP
SD-SMP NEGERI SATU ATAP BAMBU	Tojo Una-Una	SMP
SDN 1 KABALUTAN	Tojo Una-Una	SD
SDN 1 PASOKAN	Tojo Una-Una	SD
SDN 2 KABALUTAN	Tojo Una-Una	SD
SDN BANGKAGI	Tojo Una-Una	SD
SDN BAULU	Tojo Una-Una	SD
SDN BEKO	Tojo Una-Una	SD
SDN BENTENG	Tojo Una-Una	SD
SDN BIGA	Tojo Una-Una	SD
SDN BONGKAKOI	Tojo Una-Una	SD
SDN BUNGAYO	Tojo Una-Una	SD
SDN DANDA	Tojo Una-Una	SD
SDN DOLONG A	Tojo Una-Una	SD
SDN DOLONG B	Tojo Una-Una	SD
SDN KADODA	Tojo Una-Una	SD
SDN KALIA	Tojo Una-Una	SD
SDN KATUPA	Tojo Una-Una	SD
SDN KOLAMI	Tojo Una-Una	SD
SDN LANGGER	Tojo Una-Una	SD
SDN LEBITI	Tojo Una-Una	SD
SDN LEMBANATO	Tojo Una-Una	SD
SDN LOE	Tojo Una-Una	SD
SDN MALAPO	Tojo Una-Una	SD
SDN MALENGE	Tojo Una-Una	SD
SDN MATOBIAI	Tojo Una-Una	SD
SDN MELAM	Tojo Una-Una	SD
SDN MILOK	Tojo Una-Una	SD
SDN MOLOM	Tojo Una-Una	SD
SDN OLILAN	Tojo Una-Una	SD
SDN PANABALI	Tojo Una-Una	SD
SDN PAUTU	Tojo Una-Una	SD
SDN POPOLII	Tojo Una-Una	SD
SDN POPOLION	Tojo Una-Una	SD
SDN PULAU ENAM	Tojo Una-Una	SD
SDN SALINGGOHA	Tojo Una-Una	SD
SDN TITIRII	Tojo Una-Una	SD
SDN TOANI	Tojo Una-Una	SD
SDN TOJO	Tojo Una-Una	SD
SDN TONGKABO	Tojo Una-Una	SD
SDN TUMOTOK	Tojo Una-Una	SD
SDN TUMPANG	Tojo Una-Una	SD
SDN TUTUNG	Tojo Una-Una	SD
SD NURUL IHSAN SABANG	Toli-Toli	SD
SD NURUL IKHSAN	Toli-Toli	SD
SDI MUJAHIDIN	Toli-Toli	SD
SDN 1 BAMBAPULA	Toli-Toli	SD
SDN 1 BAMBAPUN	Toli-Toli	SD
SDN 1 BANAGAN	Toli-Toli	SD
SDN 1 BANGKIR	Toli-Toli	SD
SDN 1 BUGA	Toli-Toli	SD
SDN 1 DONGKO	Toli-Toli	SD
SDN 1 KOMBO	Toli-Toli	SD
SDN 1 LAIS	Toli-Toli	SD
SDN 1 LAKUAN	Toli-Toli	SD
SDN 1 OGOTUA	Toli-Toli	SD
SDN 1 OGOWELE	Toli-Toli	SD
SDN 1 OYOM	Toli-Toli	SD
SDN 1 SALUMBIA	Toli-Toli	SD
SDN 1 SONI	Toli-Toli	SD
SDN 1 TAMPIALA	Toli-Toli	SD
SDN 1 TOMPOH	Toli-Toli	SD
SDN 2 BAMBAPULA	Toli-Toli	SD
SDN 2 BAMBAPUN	Toli-Toli	SD
SDN 2 BANAGAN	Toli-Toli	SD
SDN 2 BANGKIR	Toli-Toli	SD
SDN 2 DONKO	Toli-Toli	SD
SDN 2 KOMBO	Toli-Toli	SD
SDN 2 LAIS	Toli-Toli	SD
SDN 2 LAKUAN	Toli-Toli	SD
SDN 2 OGOTUA	Toli-Toli	SD
SDN 2 OGOWELE	Toli-Toli	SD
SDN 2 SALUMBIA	Toli-Toli	SD
SDN 2 SONI	Toli-Toli	SD
SDN 2 TAMPIALA	Toli-Toli	SD
SDN 2 TOMPOH	Toli-Toli	SD
SDN 3 BAMBAPULA	Toli-Toli	SD
SDN 3 BAMBAPUN	Toli-Toli	SD
SDN 3 BANGKIR	Toli-Toli	SD
SDN 3 KOMBO	Toli-Toli	SD
SDN 3 OGOTUA	Toli-Toli	SD
SDN 3 SALUMBIA	Toli-Toli	SD
SDN 3 SONI	Toli-Toli	SD
SDN 3 TAMPIALA	Toli-Toli	SD
SDN 3 TOMPOH	Toli-Toli	SD
SDN 4 BAMBAPULA	Toli-Toli	SD
SDN 4 BANGKIR	Toli-Toli	SD
SDN 4 KOMBO	Toli-Toli	SD
SDN 4 SONI	Toli-Toli	SD
SDN 5 BANGKIR	Toli-Toli	SD
SDN 5 SONI	Toli-Toli	SD
SDN 6 BANGKIR	Toli-Toli	SD
SDN ANGGASANG	Toli-Toli	SD
SDN BOANGIN	Toli-Toli	SD
SDN GELENGE	Toli-Toli	SD
SDN INTI SIBEA	Toli-Toli	SD
SDN INTI TINADING	Toli-Toli	SD
SDN KABINUANG	Toli-Toli	SD
SDN LEMBAH HARAPAN	Toli-Toli	SD
SDN LUOK MANIPI	Toli-Toli	SD
SDN MALAMBIGU	Toli-Toli	SD
SDN MIMBALA	Toli-Toli	SD
SDN MOSING	Toli-Toli	SD
SDN OGOGASANG	Toli-Toli	SD
SDN PALEMBANG	Toli-Toli	SD
SDN PEKKASALO	Toli-Toli	SD
SDN PELEMBANG LUOK MANIPI	Toli-Toli	SD
SDN PEMBINA	Toli-Toli	SD
SDN PULAU LINGAYAN	Toli-Toli	SD
SDN PULIAS PANTE	Toli-Toli	SD
SDN SALAE	Toli-Toli	SD
SDN SESE	Toli-Toli	SD
SDN SIMATANG SABANG	Toli-Toli	SD
SDN SIMATANG TANJUNG	Toli-Toli	SD
SDN SIMATANG UTARA	Toli-Toli	SD
SDN SIMUNTU	Toli-Toli	SD
SDN SINUNGKUT	Toli-Toli	SD
SMA COKROAMINOTO TOLITOLI	Toli-Toli	SMA
SMAN 1 DAMPAL SELATAN	Toli-Toli	SMA
SMAN 1 DAMPAL UTARA	Toli-Toli	SMA
SMAS ISLAM MARADIKA	Toli-Toli	SMA
SMK AL-KALAM TOLITOLI	Toli-Toli	SMK
SMK DARUL ULUM KALANGKANGAN	Toli-Toli	SMK
SMK DDI SONI	Toli-Toli	SMK
SMK MUHAMMADIYAH DAMPAL UTARA	Toli-Toli	SMK
SMK NEGERI 1 BASI DONDO	Toli-Toli	SMK
SMK NEGERI 1 DAMPAL SELATAN	Toli-Toli	SMK
SMK NEGERI 1 DONDO	Toli-Toli	SMK
SMP KATOLIK DON BOSCO	Toli-Toli	SMP
SMP MUHAMMADIYAH SONI	Toli-Toli	SMP
SMP NEGERI 1 DAMPAL SELATAN	Toli-Toli	SMP
SMP NEGERI 1 DAMPAL UTARA	Toli-Toli	SMP
SMP NEGERI 2 DAMPAL SELATAN	Toli-Toli	SMP
SMP NEGERI 2 DAMPAL UTARA	Toli-Toli	SMP
SMP NEGERI 2 DONDO	Toli-Toli	SMP
SMP NEGERI 3 DAMPAL SELATAN	Toli-Toli	SMP
SMP NEGERI 3 DAMPAL UTARA	Toli-Toli	SMP
SMP NEGERI 3 DONDO	Toli-Toli	SMP
SMP NEGERI 4 DAMPAL SELATAN	Toli-Toli	SMP
SMP NEGERI 4 DAMPAL UTARA	Toli-Toli	SMP
SMP NEGERI 4 DONDO	Toli-Toli	SMP
SMP NEGERI 5 DAMPAL UTARA	Toli-Toli	SMP
SMP NEGERI 5 DONDO	Toli-Toli	SMP
SMP NEGERI 6 DONDO	Toli-Toli	SMP
SMP NEGERI TERBUKA DONDO 2	Toli-Toli	SMP
SMP SATU ATAP BULU MINUNG BANGKIR	Toli-Toli	SMP
SMP SATU ATAP PULAU LINGAYAN	Toli-Toli	SMP
SMP SIS AL-DJUFRIE GALANDAU BASIDONDO	Toli-Toli	SMP
